source,dataset_count,resource_count,license_count(total),open_license_count,non_open_license_count
catalogodatos.gub.uy,85,274,4,0,85
dados.gov.br,246,2113,15,40,206
data.gov.cz,178,1573,15,24,154
data.gov.sk,205,512,15,1,204
data.gov.uk,17837,58703,15,9021,8816
data.gv.at,1182,17514,3,1180,2
hubofdata.ru,5843,27316,15,488,5355
www.dati.gov.it,6933,13800,19,6372,561
www.govdata.de,6831,21332,36,4860,1971
www.publicdata.eu,48622,116333,15,19851,28771
